11111111111111111111111111111111
10000010000000000000000000000001
10000000000020000000000000000001
10000000000000000111111100001001
11111110001000000000000000001001
10000000001000000000000000001001
10302000001001111110001002001001
10000000001001000000001000000001
11111110001001000000001000000001
10000000000001003000001000100001
10302000000001000000001000100001
10000000000001000000001000100301
11111110001001111110001000100001
10000000001000000000000000111111
10000000001000000000000000000001
10020010001002000020010000020301
10000010001000000000010000000001
11111111111111111111111111111111
