11111111111111111111111111111111
10000000000000000000100000000001
10020000000003000000100000020301
10000001000000000000100000000001
11111111000100011000100011110001
10000000000100000000100000010001
10000000000000000000000000010001
10000000000000000000000000010001
10030000000001000000000000010001
10000000000001000300111100010001
10000001000001000000100000010001
10000001000001000000100000010001
10000001000111111000100000010001
10011111000000001000100000010001
10000001000000001000100000000001
10002001000020001000102000000301
10000001000000001000100000000001
11111111111111111111111111111111
