11111111111111111111111111111111
10000000000000000000100000000001
10000000000000000000100000000001
10000001000000000000100000000001
11111111000100011000100011110001
10000000000100000000100000010001
10000000000000000000000000010001
10000000000000000000000000010001
10000000000001000000000000010001
10000000000001000000111100010001
10000001000001000000100000010001
10000001000001000000100000010001
10000001000111111000100000010001
10011111000000001000100011110001
10000001000000001000100000000001
10000001000000001000100000000001
10000001000000001000100000000001
11111111111111111111111111111111
