11111111111111111111111111111111
10000010000010000000000000100001
10000010000010000000000000000001
10000010000010000000000000000001
10000011100010000001000000000001
10011110000011111111000111110001
10000000000000000000000000010001
10000000000000000000000000010001
10000000000000000000000000010001
10011111100000010000011111110001
10000010000000010000010000010001
10000010000111111100010000010001
10000010000100000000010000010001
10000010000100000000000000000001
10000010000100000000000000000001
11111111111111111111111111111111
