11111111111111111111111111111111
12000000000000010000001000000001
10000000000000010300001000000301
10011001100110010000001000000001
10011001100110011100011000111111
10000000000000000000001000000001
10000000000000000000001020000001
10011001100110000000001000000001
10011001100110000002001111110001
10000000000000000000000000000001
10000000000000000000000000000001
10020003000020000000000000000001
10000000000000000000000000000001
10011001100110011100011111110001
10011001100110010000001000000001
10000000000000010300001020030001
10000000000000010000001000000001
11111111111111111111111111111111
